XXXXXXXXXXXXXXXXXXXXXXXXXXXXXXXXXXXXXXXXX
X e                a                    X
X                                 d     X
X                                       X
X                                       X
X                                       X
X                                       X
X                                  f    X
X                                       X
X                                       X
X                                       X
X         b                             X
X                                       X
X                                       X
X                                       X
X                                       X
X                     h                 X
X                                       X
X                                       X
X                                       X
X                   A                   X
X                                       X
X                                       X
X                                       X
X         g                             X
X                                       X
X                   a                   X
X                                       X
X                                       X
X                                       X
X                      c                X
X                                       X
X                                       X
X                               b       X
X         f                             X
X                                       X
X                                       X
X                                       X
X                                       X
X                                       X
XXXXXXXXXXXXXXXXXXXXXXXXXXXXXXXXXXXXXXXXX