XXXXXXXXXXXXXXXXXXXXXXXXXXXXXXXXXXXXXXXXX
X      f                                X
X                    b                  X
X                                       X
X                c                      X
X                       h               X
X                                       X
X                                       X
X                             e         X
X                                       X
X                                       X
X              a                        X
X                                       X
X                                       X
X                                       X
X                                       X
X                                       X
X                                       X
X                                       X
X                                       X
X                   A                   X
X                                       X
X                                       X
X                                       X
X                                       X
X                                       X
X                                       X
X                                       X
X                                       X
X                            a          X
X         g                             X
X                                       X
X                                       X
X                     d                 X
X                                       X
X                                       X
X                                       X
X                                       X
X                                       X
X                         b             X
XXXXXXXXXXXXXXXXXXXXXXXXXXXXXXXXXXXXXXXXX