XXXXXXXXXXXXXXXXXXXXXXXXXXXXXXXXXXXXXXXXX
X                     f                 X
X                                       X
X                 a                     X
X                                       X
X                                       X
X     c                        b        X
X                                       X
X                                       X
X                                       X
X                                       X
X                                       X
X            h                          X
X                                       X
X                                       X
X                                       X
X                                       X
X                                       X
X                                       X
X                                       X
X                   A                   X
X                                       X
X       a                               X
X                                    d  X
X                                       X
X                                       X
X                                       X
X                                       X
X     f                                 X
X                                       X
X                                       X
X                                       X
X                                       X
X                               b       X
X                                       X
X                                       X
X                                       X
X                                 a     X
X                             e         X
Xg                                      X
XXXXXXXXXXXXXXXXXXXXXXXXXXXXXXXXXXXXXXXXX