XXXXXXXXXXXXXXXXXXXXXXXXXXXXXXXXXXXXXXXXX
X                                       X
X                                       X
X                                       X
X                               b       X
X                                       X
X                                       X
X           e            h              X
X                                       X
X                                       X
X                 a                     X
X                                       X
X                                       X
X        c                 f            X
X                                       X
X                                       X
X                                       X
X                                       X
X                                       X
X                                       X
X                   A                   X
X   d                                   X
X                                       X
X                                     f X
X                                       X
X                 a                     X
X                                       X
X                                       X
X                                       X
X                                       X
X        g                              X
X                                       X
X                                       X
X                                       X
X                                       X
X                                       X
X        e                              X
X                                       X
X                       b               X
X                                       X
XXXXXXXXXXXXXXXXXXXXXXXXXXXXXXXXXXXXXXXXX