XXXXXXXXXXXXXXXXXXXXXXXXXXXXXXXXXXXXXXXXX
X a                                     X
X                                       X
X     b                             f   X
X                                       X
X                                       X
X                                       X
X                                       X
X                                       X
X                                       X
X                                       X
X                           c           X
X                                       X
X                                       X
X      h                                X
X                                       X
X                                       X
X                                       X
X                                       X
X                                       X
X                   A                   X
X                                       X
X   e                                   X
X                                       X
X                                       X
X       f                               X
X                    g                  X
X                               d       X
X                 a                     X
X                                       X
X                                       X
X                                       X
X                                       X
X                               b       X
X                                       X
X                                       X
X                                       X
X                                       X
X                                       X
X                                       X
XXXXXXXXXXXXXXXXXXXXXXXXXXXXXXXXXXXXXXXXX