XXXXXXXXXXXXXXXXXXXXXXXXXXXXXXXXXXXXXXXXX
X       e                             f X
X                                       X
X                                       X
X                b                      X
X                                       X
X                                       X
X                                       X
X                                       X
X                                       X
X                                       X
X        a                g             X
X                                       X
X                                       X
X                                       X
X                                       X
X                                       X
X                                       X
X                                       X
X                                       X
X                   A                   X
X                                       X
X                                       X
X                                       X
X                                       X
X                                       X
X                                 b     X
X                                       X
X    d                                  X
X                                       X
X                      f                X
X                                       X
X                                       X
X                               e       X
X        c                              X
X                                       X
X                                       X
X         h                             X
X                                       X
X                              a        X
XXXXXXXXXXXXXXXXXXXXXXXXXXXXXXXXXXXXXXXXX