XXXXXXXXXXXXXXXXXXXXXXXXXXXXXXXXXXXXXXXXX
X                                       X
X                    b            f     X
X                         a             X
X                c                      X
X                       h    d          X
X                                       X
X                                       X
X                                       X
X                                       X
X                                       X
X                                       X
X                                       X
X                                       X
X                                       X
X                                       X
X                                       X
X                                       X
X               g                       X
X                                       X
X                   A                   X
X                                       X
X                                       X
X                                       X
X                                       X
X                                       X
X                                       X
X                                       X
X                                       X
X                                   e   X
X                                       X
X f                                     X
X                                       X
X                                       X
X                                       X
X                                       X
X                                       X
X                                       X
X                                       X
X   a                                   X
XXXXXXXXXXXXXXXXXXXXXXXXXXXXXXXXXXXXXXXXX