XXXXXXXXXXXXXXXXXXXXXXXXXXXXXXXXXXXXXXXXX
X     a                                 X
X                                  b    X
X                  f                    X
X                                       X
X      b                     d          X
X                                       X
X                                       X
X                                       X
X                                       X
X          c                            X
X                                       X
X                                       X
X                                       X
X                                       X
X                     h                 X
X                                       X
X                                       X
X                                       X
X                                       X
X        g          A                   X
X                                       X
X                                       X
X                                       X
X                                       X
X                                       X
X              e                        X
X                                       X
X                                       X
X                                       X
X                                       X
X                                       X
X                                       X
X                a                      X
X                                       X
X                                       X
X                                       X
X                                       X
X                                f      X
Xg                                      X
XXXXXXXXXXXXXXXXXXXXXXXXXXXXXXXXXXXXXXXXX